㮝	㮝
䀘	䀘
一	⼀
不	不
丨	⼁
串	串
丶	⼂
丹	丹
丿	⼃
乙	⼄
亂	亂
亅	⼅
了	了
二	⼆
亠	⼇
亮	亮
人	⼈
什	什
令	令
侀	侀
來	來
例	例
侮	侮
便	便
倫	倫
僚	僚
僧	僧
儿	⼉
兀	兀
免	免
入	⼊
兩	兩
八	⼋
六	六
冂	⼌
冖	⼍
冫	⼎
冷	冷
凉	凉
凌	凌
凜	凜
凞	凞
几	⼏
凵	⼐
刀	⼑
切	切
列	列
利	利
刺	刺
劉	劉
力	⼒
劣	劣
勉	勉
勒	勒
勞	勞
勤	勤
勵	勵
勹	⼓
匕	⼔
北	北
匚	⼕
匸	⼖
匿	匿
十	⼗
卄	〹
卑	卑
卜	⼘
卩	⼙
卵	卵
厂	⼚
厶	⼛
參	參
又	⼜
口	⼝
句	句
吏	吏
吝	吝
呂	呂
咽	咽
喇	喇
喝	喝
嗀	嗀
嘆	嘆
器	器
囗	⼞
囹	囹
土	⼟
塀	塀
塚	塚
塞	塞
墨	墨
壘	壘
壟	壟
士	⼠
夂	⼡
夊	⼢
夕	⼣
大	⼤
奈	奈
契	契
女	⼥
嬨	嬨
子	⼦
宀	⼧
宅	宅
寧	寧
寮	寮
寸	⼨
小	⼩
尢	⼪
尸	⼫
尿	尿
屢	屢
層	層
履	履
屮	⼬
山	⼭
崙	崙
嵐	嵐
嶺	嶺
巛	⼮
工	⼯
己	⼰
巾	⼱
干	⼲
年	年
幺	⼳
广	⼴
度	度
廉	廉
廊	廊
廓	廓
廬	廬
廴	⼵
廾	⼶
弄	弄
弋	⼷
弓	⼸
彐	⼹
彡	⼺
彳	⼻
律	律
復	復
心	⼼
念	念
怒	怒
怜	怜
恵	恵
悔	悔
惡	惡
慄	慄
慨	慨
憎	憎
憐	憐
懲	懲
懶	懶
戀	戀
戈	⼽
戮	戮
戶	⼾
手	⼿
拉	拉
拏	拏
拓	拓
拾	拾
捻	捻
掠	掠
撚	撚
擄	擄
支	⽀
攴	⽁
敏	敏
數	數
文	⽂
斗	⽃
料	料
斤	⽄
方	⽅
旅	旅
无	⽆
既	既
日	⽇
易	易
晴	晴
暈	暈
暑	暑
暴	暴
曆	曆
曰	⽈
更	更
月	⽉
朗	朗
木	⽊
李	李
杻	杻
林	林
柳	柳
栗	栗
梁	梁
梅	梅
梨	梨
樂	樂
樓	樓
櫓	櫓
欄	欄
欠	⽋
止	⽌
歷	歷
歹	⽍
殮	殮
殳	⽎
殺	殺
毋	⽏
母	⺟
比	⽐
毛	⽑
氏	⽒
气	⽓
水	⽔
沈	沈
泌	泌
泥	泥
洛	洛
洞	洞
流	流
浪	浪
海	海
淋	淋
淚	淚
淪	淪
渚	渚
溜	溜
溺	溺
滑	滑
漏	漏
漢	漢
漣	漣
濫	濫
濾	濾
火	⽕
炙	炙
烈	烈
烙	烙
煉	煉
煮	煮
燎	燎
燐	燐
爐	爐
爛	爛
爪	⽖
爫	爫
父	⽗
爻	⽘
爿	⽙
片	⽚
牙	⽛
牛	⽜
牢	牢
犬	⽝
狀	狀
狼	狼
猪	猪
獵	獵
玄	⽞
率	率
玉	⽟
玲	玲
珞	珞
理	理
琉	琉
琢	琢
瑩	瑩
璉	璉
璘	璘
瓜	⽠
瓦	⽡
甘	⽢
生	⽣
用	⽤
田	⽥
留	留
略	略
異	異
疋	⽦
疒	⽧
痢	痢
療	療
癩	癩
癶	⽨
白	⽩
皮	⽪
皿	⽫
益	益
盧	盧
目	⽬
省	省
矛	⽭
矢	⽮
石	⽯
硫	硫
碌	碌
碑	碑
磊	磊
磻	磻
礪	礪
示	⽰
礼	礼
社	社
祈	祈
祉	祉
祐	祐
祖	祖
祝	祝
神	神
祥	祥
祿	祿
禍	禍
禎	禎
福	福
禮	禮
禸	⽱
禾	⽲
秊	秊
稜	稜
穀	穀
穴	⽳
突	突
立	⽴
竹	⽵
笠	笠
節	節
簾	簾
籠	籠
米	⽶
粒	粒
精	精
糖	糖
糧	糧
糸	⽷
紐	紐
索	索
累	累
綠	綠
綾	綾
練	練
縉	縉
縷	縷
繁	繁
缶	⽸
网	⽹
署	署
罹	罹
羅	羅
羊	⽺
羚	羚
羽	⽻
老	⽼
者	者
而	⽽
耒	⽾
耳	⽿
聆	聆
聯	聯
聾	聾
聿	⾀
肉	⾁
肋	肋
臘	臘
臣	⾂
臨	臨
自	⾃
臭	臭
至	⾄
臼	⾅
舌	⾆
舘	舘
舛	⾇
舟	⾈
艮	⾉
良	良
色	⾊
艸	⾋
艹	艹
若	若
茶	茶
菉	菉
菱	菱
落	落
葉	葉
著	著
蓮	蓮
蓼	蓼
藍	藍
藺	藺
蘆	蘆
蘒	蘒
蘭	蘭
蘿	蘿
虍	⾌
虜	虜
虫	⾍
螺	螺
蠟	蠟
血	⾎
行	⾏
衣	⾐
裂	裂
裏	裏
裡	裡
裸	裸
褐	褐
襤	襤
襾	⾑
見	⾒
視	視
角	⾓
言	⾔
說	說
諒	諒
論	論
諸	諸
諾	諾
謁	謁
謹	謹
識	識
讀	讀
谷	⾕
豆	⾖
豈	豈
豕	⾗
豸	⾘
貝	⾙
賂	賂
賈	賈
賓	賓
贈	贈
赤	⾚
走	⾛
足	⾜
路	路
身	⾝
車	⾞
輦	輦
輪	輪
輻	輻
辛	⾟
辰	⾠
辵	⾡
辶	辶
連	連
逸	逸
遼	遼
邏	邏
邑	⾢
郎	郎
都	都
酉	⾣
酪	酪
醴	醴
釆	⾤
里	⾥
量	量
金	⾦
鈴	鈴
錄	錄
鍊	鍊
長	⾧
門	⾨
閭	閭
阜	⾩
阮	阮
降	降
陵	陵
陸	陸
隆	隆
隣	隣
隶	⾪
隸	隸
隹	⾫
離	離
難	難
雨	⾬
零	零
雷	雷
露	露
靈	靈
靑	⾭
靖	靖
非	⾮
面	⾯
革	⾰
韋	⾱
韭	⾲
音	⾳
響	響
頁	⾴
領	領
頻	頻
類	類
風	⾵
飛	⾶
食	⾷
飯	飯
飼	飼
館	館
首	⾸
香	⾹
馬	⾺
駱	駱
驪	驪
骨	⾻
高	⾼
髟	⾽
鬥	⾾
鬯	⾿
鬲	⿀
鬼	⿁
魚	⿂
魯	魯
鱗	鱗
鳥	⿃
鶴	鶴
鷺	鷺
鸞	鸞
鹵	⿄
鹿	⿅
麗	麗
麟	麟
麥	⿆
麻	⿇
黃	⿈
黍	⿉
黎	黎
黑	⿊
黹	⿋
黽	⿌
鼎	⿍
鼓	⿎
鼠	⿏
鼻	⿐
齊	⿑
齒	⿒
龍	⿓
龜	⿔
龠	⿕